NO ./assets/textures/Rocky_Road_64x64.png
SO ./assets/textures/Brick_Wall_Cracked_64x64.png
WE ./assets/textures/colorstone.png
EA ./assets/textures/mossy.png
F 220,100,0
C 0,10,0


11111111111111111111111111111111111111111111
100000000000000000000001101      101     101
111111000000000000000001101      101     101    
111111000000000000000001101      101     101
1  111000011011000000000001      101     101    
111100000100001000000001111      101     101
100000001000000100000001       1110111111101
10000011000000001100001        1000000001101
100000100000000000100001       1000000001101
100000111100001111000001       1000000000001
10000000001001000000111111111111000000001111
10000000001000000000000000000000000000001
10000000001111100000111111111111000000001111111
100000000001100000000001       1000000000000001
100000000000000000000001       1000000001111101
1000000000000000N0000001       1111111111   101
100001111110000000000001                    101
100001    10000000000011                    101
100001111111111111111111                    101
110000000000000000000001                    101
 1111011111111111111111                     101
    101                                     101
    101                                     101
    101                                     101
    1011111111111111111111111111111111111111101
    1000000000000000000000000000000000000000001
    1011111111111111111111111111111111111111111
    101
    10111
    10001
    11111