NO ./assets/textures/Brick_Texture.png
SO ./assets/textures/Brickwall_Texture.png
WE ./assets/textures/Brickwall2_Texture.png
EA ./assets/textures/Brickwall3_Texture.png
F 220,100,0
C 225,30,0
1111111111111111111111111    1111111
1000000000110000000000001    1001111
1011000001110000000000001    1000001
10010000000000000000000011    000001
110000000000000000000000000000000001
100000000000000001111111111111111001
111101000000E00001      100011111001
111101111111110111111111100000000001
110000001111010111000000000011111111
10000000000000001100000000001
10000000000000001101010010000
1100000           111011110001
11110111         100000000001
11111111         111111111111